1111111111111111111111111
1000010011001900100010001
1011011000001110101000101
1001011011111100000111101
1101011010001001010000101
1001011000101011001010101
1011010010101011011010001
1001110110111000001111101
1100000010101010101000001
1001111100101010100010101
1011000110101100111110111
1001010010001100100010001
1001011010101100101011101
1011010010101001111010001
1000011110101010001000101
1011110000101010100110101
1000000111191000110000101
1111111111111111111111111
