1111111111111111111111111
1000000000001000000000001
1000000000001000000000001
1001111011001001111011001
1010200202101010200202101
1010111212101010111212101
1010020222101010020222101
1000211201001000211201001
1100222200001100222200001
1001111110001001111110001
1000000000001000000000001
1000000000001000000000001
1000000000001000000000001
1000000000001000000000001
1000000000001000000000001
1000000000001000000000001
1000000000001000000000001
1111111111111111111111111